26 20
400 200
 8  8  8  8  8  8  8  8  8 1 1 1 1 1 1 0 1 0 0 1 1 0 0 0 0 0
 9  9  9  9  9  9  9  9  9 1 1 0 1 1 1 1 1 0 0 0 0 0 1 0 0 0
10 10 10 10 10 10 10 10 10 1 0 1 0 0 1 0 1 0 0 0 1 1 0 0 0 0
11 11 11 11 11 11 11 11 11 1 1 1 0 1 1 1 1 1 0 0 0 1 0 0 0 0
1  1  1  1  4  1  1  1  1  1 0 1 1 1 0 1 0 1 1 1 0 0 0 1 0 0
1  1  1  1  6  1  1  1  1  1 0 0 1 0 0 1 1 0 1 1 1 0 1 1 1 0
1  1  1  1  6  1  1  1  1  1 1 0 1 1 0 0 1 1 1 1 1 0 0 0 0 0
1  1  1  1  6  1  1  1  1  1 1 1 1 1 1 1 1 1 1 1 1 0 0 1 1 0
1 1 1 1 6 1 0 0 0 0 0 0 0  0 0 0 0 0 0 0 0 0 0 0 0 0
6 6 6 6 6 6 6 6 6 6 6 6 6  6 6 6 6 6 6 6 6 6 6 6 6 6
12 12 12 12 12 12 12 12 12 12 12 6 6 12 12 12 12 12 12 12 12 12 12 12 12 12
12 12 12 12 12 12 12 12 12 12 12 6 6 12 12 12 12 12 12 12 12 12 12 12 12 12
12 12 12 12 12 12 12 12 12 12 12 6 6 12 12 12 12 12 12 12 12 12 12 12 12 12
12 12 12 12 12 12 12 12 12 12 12 6 6 12 12 12 12 12 12 12 12 12 12 12 12 12
12 12 12 12 12 12 12 12 12 12 12 6 6 12 12 12 12 12 12 12 12 12 12 12 12 12
12 12 12 12 12 12 12 12 12 12 12 6 6 12 12 12 12 12 12 12 12 12 12 12 12 12
12 12 12 12 12 12 12 12 12 12 12 6 6 12 12 12 12 12 12 12 12 12 12 12 12 12
12 12 12 12 12 12 12 12 12 12 12 6 6 12 12 12 12 12 12 12 12 12 12 12 12 12
12 12 12 12 12 12 12 12 12 12 12 6 6 12 12 12 12 12 12 12 12 12 12 12 12 12
12 12 12 12 12 12 12 12 12 12 12 6 6 12 12 12 12 12 12 12 12 12 12 12 12 12
